# Pixel_X Pixel_Y Center Sum_C Sum_U Sum_D Sum_L Sum_R Avg0_C Avg0_U Avg0_D Avg0_L Avg0_R
0 0 0 -12740 -7644 -7644 -7680 -7620 -510 -510 -510 -512 -508
1 0 4 -12680 -7608 -7608 -7660 -7560 -508 -508 -508 -511 -504
2 0 8 -12600 -7560 -7560 -7620 -7500 -504 -504 -504 -508 -500
3 0 12 -12500 -7500 -7500 -7560 -7440 -500 -500 -500 -504 -496
4 0 16 -12400 -7440 -7440 -7500 -7380 -496 -496 -496 -500 -492
5 0 20 -12300 -7380 -7380 -7440 -7320 -492 -492 -492 -496 -488
6 0 24 -12200 -7320 -7320 -7380 -7260 -488 -488 -488 -492 -484
7 0 28 -12100 -7260 -7260 -7320 -7200 -484 -484 -484 -488 -480
8 0 32 -12000 -7200 -7200 -7260 -7140 -480 -480 -480 -484 -476
9 0 36 -11900 -7140 -7140 -7200 -7080 -476 -476 -476 -480 -472
10 0 40 -11800 -7080 -7080 -7140 -7020 -472 -472 -472 -476 -468
11 0 44 -11700 -7020 -7020 -7080 -6960 -468 -468 -468 -472 -464
12 0 48 -11600 -6960 -6960 -7020 -6900 -464 -464 -464 -468 -460
13 0 52 -11500 -6900 -6900 -6960 -6840 -460 -460 -460 -464 -456
14 0 56 -11420 -6852 -6852 -6900 -6800 -457 -457 -457 -460 -454
15 0 60 -11360 -6816 -6816 -6840 -6780 -455 -455 -455 -456 -452
0 1 64 -11140 -6684 -6684 -6720 -6660 -446 -446 -446 -448 -444
1 1 68 -11080 -6648 -6648 -6700 -6600 -444 -444 -444 -447 -440
2 1 72 -11000 -6600 -6600 -6660 -6540 -440 -440 -440 -444 -436
3 1 76 -10900 -6540 -6540 -6600 -6480 -436 -436 -436 -440 -432
4 1 80 -10800 -6480 -6480 -6540 -6420 -432 -432 -432 -436 -428
5 1 84 -10700 -6420 -6420 -6480 -6360 -428 -428 -428 -432 -424
6 1 88 -10600 -6360 -6360 -6420 -6300 -424 -424 -424 -428 -420
7 1 92 -10500 -6300 -6300 -6360 -6240 -420 -420 -420 -424 -416
8 1 96 -10400 -6240 -6240 -6300 -6180 -416 -416 -416 -420 -412
9 1 100 -10300 -6180 -6180 -6240 -6120 -412 -412 -412 -416 -408
10 1 104 -10200 -6120 -6120 -6180 -6060 -408 -408 -408 -412 -404
11 1 108 -10100 -6060 -6060 -6120 -6000 -404 -404 -404 -408 -400
12 1 112 -10000 -6000 -6000 -6060 -5940 -400 -400 -400 -404 -396
13 1 116 -9900 -5940 -5940 -6000 -5880 -396 -396 -396 -400 -392
14 1 120 -9820 -5892 -5892 -5940 -5840 -393 -393 -393 -396 -390
15 1 124 -9760 -5856 -5856 -5880 -5820 -391 -391 -391 -392 -388
0 2 123 -8511 -5655 -4741 -5229 -5025 -341 -377 -317 -349 -335
1 2 124 -8304 -5472 -4656 -5218 -4818 -333 -365 -311 -348 -322
2 2 182 -8080 -5280 -4560 -5025 -4605 -324 -352 -304 -335 -307
3 2 184 -7842 -5082 -4454 -4818 -4560 -314 -339 -297 -322 -304
4 2 187 -7598 -4878 -4346 -4605 -4512 -304 -326 -290 -307 -301
5 2 189 -7519 -4839 -4293 -4560 -4464 -301 -323 -287 -304 -298
6 2 192 -7440 -4800 -4240 -4512 -4416 -298 -320 -283 -301 -295
7 2 195 -7361 -4761 -4187 -4464 -4368 -295 -318 -280 -298 -292
8 2 197 -7282 -4722 -4134 -4416 -4323 -292 -315 -276 -295 -289
9 2 200 -7203 -4683 -4081 -4368 -4275 -289 -313 -273 -292 -285
10 2 202 -7127 -4647 -4029 -4323 -4230 -286 -310 -269 -289 -282
11 2 205 -7045 -4605 -3975 -4275 -4179 -282 -307 -265 -285 -279
12 2 207 -7119 -4719 -3973 -4230 -4284 -285 -315 -265 -282 -286
13 2 211 -7184 -4824 -3968 -4179 -4380 -288 -322 -265 -279 -292
14 2 162 -7266 -4938 -3974 -4284 -4496 -291 -330 -265 -286 -300
15 2 167 -7362 -5058 -3990 -4380 -4473 -295 -338 -266 -292 -299
0 3 155 -7421 -5205 -3951 -4557 -4383 -297 -347 -264 -304 -293
1 3 157 -7244 -5052 -3876 -4543 -4206 -290 -337 -259 -303 -281
2 3 203 -7032 -4872 -3784 -4383 -4008 -282 -325 -253 -293 -268
3 3 206 -6803 -4683 -3681 -4206 -3939 -273 -313 -246 -281 -263
4 3 215 -6571 -4491 -3577 -4008 -3870 -263 -300 -239 -268 -258
5 3 218 -6471 -4431 -3517 -3939 -3822 -259 -296 -235 -263 -255
6 3 221 -6371 -4371 -3457 -3870 -3774 -255 -292 -231 -258 -252
7 3 223 -6289 -4329 -3403 -3822 -3726 -252 -289 -227 -255 -249
8 3 226 -6210 -4290 -3350 -3774 -3678 -249 -286 -224 -252 -246
9 3 229 -6131 -4251 -3297 -3726 -3630 -246 -284 -220 -249 -242
10 3 231 -6058 -4218 -3246 -3678 -3591 -243 -282 -217 -246 -240
11 3 234 -5991 -4191 -3197 -3630 -3555 -240 -280 -214 -242 -237
12 3 234 -6044 -4284 -3188 -3591 -3639 -242 -286 -213 -240 -243
13 3 235 -6094 -4374 -3178 -3555 -3714 -244 -292 -212 -237 -248
14 3 198 -6161 -4473 -3179 -3639 -3800 -247 -299 -212 -243 -254
15 3 201 -6236 -4572 -3188 -3714 -3783 -250 -305 -213 -248 -253
0 4 208 -6037 -4461 -3063 -3696 -3573 -242 -298 -205 -247 -239
1 4 218 -5899 -4347 -3001 -3658 -3435 -236 -290 -201 -244 -229
2 4 231 -5669 -4149 -2903 -3573 -3243 -227 -277 -194 -239 -217
3 4 246 -5404 -3924 -2788 -3435 -3063 -217 -262 -186 -229 -205
4 4 274 -5163 -3723 -2681 -3243 -2922 -207 -249 -179 -217 -195
5 4 283 -4958 -3558 -2586 -3063 -2862 -199 -238 -173 -205 -191
6 4 285 -4795 -3435 -2505 -2922 -2826 -192 -229 -167 -195 -189
7 4 286 -4713 -3393 -2451 -2862 -2793 -189 -227 -164 -191 -187
8 4 287 -4652 -3372 -2404 -2826 -2757 -187 -225 -161 -189 -184
9 4 288 -4594 -3354 -2358 -2793 -2721 -184 -224 -158 -187 -182
10 4 290 -4572 -3372 -2324 -2757 -2721 -183 -225 -155 -184 -182
11 4 291 -4583 -3423 -2301 -2721 -2757 -184 -229 -154 -182 -184
12 4 280 -4633 -3513 -2291 -2721 -2832 -186 -235 -153 -182 -189
13 4 270 -4728 -3648 -2296 -2757 -2913 -190 -244 -154 -184 -195
14 4 258 -4834 -3786 -2310 -2832 -2972 -194 -253 -154 -189 -199
15 4 245 -4915 -3891 -2321 -2913 -3003 -197 -260 -155 -195 -201
0 5 203 -5484 -4548 -2452 -3357 -3246 -220 -304 -164 -224 -217
1 5 212 -5352 -4440 -2392 -3322 -3114 -215 -296 -160 -222 -208
2 5 223 -5131 -4251 -2297 -3246 -2928 -206 -284 -154 -217 -196
3 5 239 -4872 -4032 -2184 -3114 -2745 -195 -269 -146 -208 -183
4 5 266 -4619 -3819 -2073 -2928 -2589 -185 -255 -139 -196 -173
5 5 276 -4390 -3630 -1970 -2745 -2505 -176 -242 -132 -183 -167
6 5 283 -4203 -3483 -1881 -2589 -2445 -169 -233 -126 -173 -163
7 5 286 -4094 -3414 -1818 -2505 -2403 -164 -228 -122 -167 -161
8 5 288 -4012 -3372 -1764 -2445 -2367 -161 -225 -118 -163 -158
9 5 289 -3948 -3348 -1716 -2403 -2334 -158 -224 -115 -161 -156
10 5 290 -3926 -3366 -1682 -2367 -2337 -158 -225 -113 -158 -156
11 5 291 -3946 -3426 -1662 -2334 -2379 -158 -229 -111 -156 -159
12 5 280 -4005 -3525 -1655 -2337 -2460 -161 -235 -111 -156 -164
13 5 268 -4100 -3660 -1660 -2379 -2541 -164 -244 -111 -159 -170
14 5 256 -4206 -3798 -1674 -2460 -2594 -169 -254 -112 -164 -173
15 5 245 -4287 -3903 -1685 -2541 -2619 -172 -261 -113 -170 -175
0 6 241 -3680 -3384 -1424 -2631 -1926 -148 -226 -95 -176 -129
1 6 351 -3566 -3294 -1370 -2293 -1812 -143 -220 -92 -153 -121
2 6 358 -3384 -3144 -1288 -1926 -1968 -136 -210 -86 -129 -132
3 6 271 -3146 -2946 -1182 -1812 -2097 -126 -197 -79 -121 -140
4 6 291 -3193 -3033 -1171 -1968 -1920 -128 -203 -79 -132 -128
5 6 307 -3246 -3126 -1162 -2097 -1788 -130 -209 -78 -140 -120
6 6 322 -3032 -2952 -1064 -1920 -1698 -122 -197 -71 -128 -114
7 6 327 -2875 -2835 -985 -1788 -1650 -115 -189 -66 -120 -110
8 6 329 -2766 -2766 -922 -1698 -1617 -111 -185 -62 -114 -108
9 6 330 -2717 -2757 -879 -1650 -1605 -109 -184 -59 -110 -107
10 6 330 -2716 -2796 -852 -1617 -1629 -109 -187 -57 -108 -109
11 6 325 -2766 -2886 -842 -1605 -1698 -111 -193 -57 -107 -114
12 6 314 -2855 -3015 -845 -1629 -1788 -115 -201 -57 -109 -120
13 6 299 -2698 -2898 -766 -1698 -1599 -108 -194 -52 -114 -107
14 6 287 -2534 -2766 -690 -1788 -1373 -102 -185 -46 -120 -92
15 6 369 -2345 -2601 -611 -1599 -1119 -94 -174 -41 -107 -75
0 7 342 -2158 -2502 -490 -1338 -1266 -87 -167 -33 -90 -85
1 7 347 -2074 -2442 -446 -1315 -1182 -83 -163 -30 -88 -79
2 7 353 -1958 -2358 -386 -1266 -1089 -79 -158 -26 -85 -73
3 7 362 -1810 -2250 -310 -1182 -990 -73 -150 -21 -79 -66
4 7 370 -1659 -2139 -233 -1089 -900 -67 -143 -16 -73 -60
5 7 378 -1733 -2253 -231 -990 -1041 -70 -151 -16 -66 -70
6 7 384 -1819 -2379 -233 -900 -1191 -73 -159 -16 -60 -80
7 7 315 -1926 -2526 -242 -1041 -1356 -78 -169 -17 -70 -91
8 7 320 -2057 -2697 -259 -1191 -1314 -83 -180 -18 -80 -88
9 7 321 -2008 -2688 -216 -1356 -1089 -81 -180 -15 -91 -73
10 7 321 -1764 -2484 -108 -1314 -879 -71 -166 -8 -88 -59
11 7 387 -1553 -2313 -11 -1089 -687 -63 -155 -1 -73 -46
12 7 383 -1363 -2163 79 -879 -711 -55 -145 5 -59 -48
13 7 377 -1185 -2025 165 -687 -735 -48 -135 11 -46 -49
14 7 371 -1213 -2085 177 -711 -749 -49 -139 11 -48 -50
15 7 367 -1237 -2133 185 -735 -753 -50 -143 12 -49 -51
0 8 385 -873 -1857 365 -567 -495 -35 -124 24 -38 -33
1 8 390 -795 -1803 407 -544 -417 -32 -121 27 -37 -28
2 8 396 -718 -1758 454 -495 -363 -29 -118 30 -33 -25
3 8 403 -642 -1722 506 -417 -336 -26 -115 33 -28 -23
4 8 400 -563 -1683 559 -363 -312 -23 -113 37 -25 -21
5 8 397 -487 -1647 611 -336 -264 -20 -110 40 -23 -18
6 8 403 -426 -1626 658 -312 -201 -18 -109 43 -21 -14
7 8 408 -353 -1593 709 -264 -153 -15 -107 47 -18 -11
8 8 410 -274 -1554 762 -201 -123 -11 -104 50 -14 -9
9 8 411 -225 -1545 805 -153 -111 -9 -103 53 -11 -8
10 8 410 -206 -1566 838 -123 -117 -9 -105 55 -9 -8
11 8 406 -181 -1581 873 -111 -108 -8 -106 58 -8 -8
12 8 401 -144 -1584 912 -117 -72 -6 -106 60 -8 -5
13 8 405 -86 -1566 958 -108 -3 -4 -105 63 -8 -1
14 8 410 -24 -1536 1000 -72 46 -1 -103 66 -5 3
15 8 416 45 -1491 1039 -3 72 1 -100 69 -1 4
0 9 421 280 -1344 1176 141 186 11 -90 78 9 12
1 9 423 334 -1314 1210 155 240 13 -88 80 10 16
2 9 426 408 -1272 1256 186 300 16 -85 83 12 20
3 9 431 475 -1245 1305 240 336 19 -83 87 16 22
4 9 435 524 -1236 1348 300 345 20 -83 89 20 23
5 9 430 546 -1254 1382 336 324 21 -84 92 22 21
6 9 426 535 -1305 1405 345 300 21 -87 93 23 20
7 9 420 509 -1371 1423 324 285 20 -92 94 21 19
8 9 414 522 -1398 1454 300 312 20 -94 96 20 20
9 9 413 568 -1392 1496 285 378 22 -93 99 19 25
10 9 421 650 -1350 1550 312 465 26 -90 103 20 31
11 9 428 765 -1275 1615 378 543 30 -85 107 25 36
12 9 434 877 -1203 1679 465 594 35 -81 111 31 39
13 9 439 959 -1161 1733 543 621 38 -78 115 36 41
14 9 437 1012 -1140 1772 594 625 40 -76 118 39 41
15 9 435 1039 -1137 1797 621 627 41 -76 119 41 41
0 10 446 1292 -972 1940 750 792 51 -65 129 50 52
1 10 448 1331 -957 1969 764 831 53 -64 131 50 55
2 10 450 1384 -936 2008 792 870 55 -63 133 52 58
3 10 451 1448 -912 2056 831 906 57 -61 137 55 60
4 10 453 1509 -891 2103 870 942 60 -60 140 58 62
5 10 454 1567 -873 2149 906 975 62 -59 143 60 65
6 10 455 1628 -852 2196 942 1011 65 -57 146 62 67
7 10 456 1683 -837 2241 975 1044 67 -56 149 65 69
8 10 458 1732 -828 2284 1011 1071 69 -56 152 67 71
9 10 458 1778 -822 2326 1044 1092 71 -55 155 69 72
10 10 457 1821 -819 2367 1071 1113 72 -55 157 71 74
11 10 457 1861 -819 2407 1092 1140 74 -55 160 72 76
12 10 457 1904 -816 2448 1113 1170 76 -55 163 74 78
13 10 458 1956 -804 2492 1140 1206 78 -54 166 76 80
14 10 459 2000 -792 2528 1170 1231 80 -53 168 78 82
15 10 461 2036 -780 2556 1206 1245 81 -52 170 80 83
0 11 467 2241 -663 2683 1323 1359 89 -45 178 88 90
1 11 468 2277 -651 2711 1334 1395 91 -44 180 88 93
2 11 470 2321 -639 2747 1359 1428 92 -43 183 90 95
3 11 471 2373 -627 2791 1395 1455 94 -42 186 93 97
4 11 471 2416 -624 2832 1428 1473 96 -42 188 95 98
5 11 471 2447 -633 2869 1455 1485 97 -43 191 97 99
6 11 469 2472 -648 2904 1473 1494 98 -44 193 98 99
7 11 467 2497 -663 2939 1485 1509 99 -45 195 99 100
8 11 466 2528 -672 2976 1494 1536 101 -45 198 99 102
9 11 466 2574 -666 3018 1509 1575 102 -45 201 100 105
10 11 468 2635 -645 3065 1536 1623 105 -43 204 102 108
11 11 471 2705 -615 3115 1575 1671 108 -41 207 105 111
12 11 474 2778 -582 3166 1623 1713 111 -39 211 108 114
13 11 476 2845 -555 3215 1671 1746 113 -37 214 111 116
14 11 477 2895 -537 3253 1713 1765 115 -36 216 114 117
15 11 477 2928 -528 3280 1746 1773 117 -36 218 116 118
0 12 483 3118 -426 3402 1851 1884 124 -29 226 123 125
1 12 484 3151 -417 3429 1862 1917 126 -28 228 124 127
2 12 485 3195 -405 3465 1884 1950 127 -27 231 125 130
3 12 486 3250 -390 3510 1917 1983 130 -26 234 127 132
4 12 487 3305 -375 3555 1950 2016 132 -25 237 130 134
5 12 488 3360 -360 3600 1983 2049 134 -24 240 132 136
6 12 489 3412 -348 3644 2016 2079 136 -24 242 134 138
7 12 490 3464 -336 3688 2049 2109 138 -23 245 136 140
8 12 490 3513 -327 3731 2079 2136 140 -22 248 138 142
9 12 491 3559 -321 3773 2109 2163 142 -22 251 140 144
10 12 491 3605 -315 3815 2136 2190 144 -21 254 142 146
11 12 491 3651 -309 3857 2163 2217 146 -21 257 144 147
12 12 492 3697 -303 3899 2190 2247 147 -21 259 146 149
13 12 492 3746 -294 3942 2217 2277 149 -20 262 147 151
14 12 493 3787 -285 3977 2247 2299 151 -19 265 149 153
15 12 494 3817 -279 4003 2277 2310 152 -19 266 151 154
0 13 498 3983 -201 4117 2370 2403 159 -14 274 158 160
1 13 499 4013 -195 4143 2381 2433 160 -13 276 158 162
2 13 500 4054 -186 4178 2403 2463 162 -13 278 160 164
3 13 500 4100 -180 4220 2433 2487 164 -12 281 162 165
4 13 501 4143 -177 4261 2463 2511 165 -12 284 164 167
5 13 500 4183 -177 4301 2487 2532 167 -12 286 165 168
6 13 500 4223 -177 4341 2511 2556 168 -12 289 167 170
7 13 500 4260 -180 4380 2532 2580 170 -12 292 168 172
8 13 500 4306 -174 4422 2556 2610 172 -12 294 170 174
9 13 500 4355 -165 4465 2580 2643 174 -11 297 172 176
10 13 502 4410 -150 4510 2610 2682 176 -10 300 174 178
11 13 503 4468 -132 4556 2643 2718 178 -9 303 176 181
12 13 505 4529 -111 4603 2682 2754 181 -8 306 178 183
13 13 506 4584 -96 4648 2718 2784 183 -7 309 181 185
14 13 507 4628 -84 4684 2754 2803 185 -6 312 183 186
15 13 507 4658 -78 4710 2784 2811 186 -6 314 185 187
0 14 512 4507 3 4505 2688 2715 180 0 300 179 181
1 14 512 4537 9 4531 2696 2745 181 0 302 179 183
2 14 513 4578 18 4566 2715 2778 183 1 304 181 185
3 14 514 4630 30 4610 2745 2811 185 2 307 183 187
4 14 515 4682 42 4654 2778 2841 187 2 310 185 189
5 14 516 4734 54 4698 2811 2871 189 3 313 187 191
6 14 516 4786 66 4742 2841 2901 191 4 316 189 193
7 14 517 4838 78 4786 2871 2934 193 5 319 191 195
8 14 518 4887 87 4829 2901 2964 195 5 321 193 197
9 14 519 4939 99 4873 2934 2994 197 6 324 195 199
10 14 519 4988 108 4916 2964 3021 199 7 327 197 201
11 14 520 5037 117 4959 2994 3051 201 7 330 199 203
12 14 520 5086 126 5002 3021 3081 203 8 333 201 205
13 14 521 5135 135 5045 3051 3111 205 9 336 203 207
14 14 522 5173 141 5079 3081 3130 206 9 338 205 208
15 14 522 5203 147 5105 3111 3138 208 9 340 207 209
0 15 525 335 201 201 195 205 13 13 13 13 13
1 15 526 345 207 207 200 215 13 13 13 13 14
2 15 526 355 213 213 205 220 14 14 14 13 14
3 15 527 370 222 222 215 230 14 14 14 14 15
4 15 527 380 228 228 220 235 15 15 15 14 15
5 15 528 395 237 237 230 245 15 15 15 15 16
6 15 528 405 243 243 235 250 16 16 16 15 16
7 15 529 420 252 252 245 260 16 16 16 16 17
8 15 529 435 261 261 250 270 17 17 17 16 18
9 15 530 455 273 273 260 285 18 18 18 17 19
10 15 531 475 285 285 270 300 19 19 19 18 20
11 15 532 500 300 300 285 315 20 20 20 19 21
12 15 533 525 315 315 300 330 21 21 21 20 22
13 15 534 545 327 327 315 340 21 21 21 21 22
14 15 535 560 336 336 330 345 22 22 22 22 23
15 15 535 570 342 342 340 345 22 22 22 22 23
